POčet chýb je 9 v datasete

Personal - sex ? missing values OK
Roky rôzne formáty, + datatime	OK
Adresa - \n new line feed - format - môže byť
Mena - duplicity	OK
Indexácia - dirty	môže byť pri mergnutí problém

Other
Indexácia - dirty
Mená - duplikáty
Adresa - rovnako ako personal
Class - kategorické a numerické hodnoty OK
Medical info - json, - iné hodnoty	OK rozparsovať 
On Antithyroid medication - rôzne formáty - F,f,T,t OK
TGB = ? prázdny, celý stĺpce			
TGG_measured = f
FTI - ?,NaN values	
education NUM = zaporné hodnoty OK

Query hyperthroid - neplatné hodnoty f.8
FTI measured = rovnanko - t.4 



***********************************
Nové chyby - Personal_train.csv
Name - duplicity, rovnako ako Other_train.csv
Age - invalid values - 455
Date of birth - date format invalid values

Other train -
query - hyperthroid - f.8
FTI - measured t.4
Capital - gain - Vysoký rozdiel hodnôt
on antithyroid medication - FALSE/F  - nesprávny formát
referal source - other???
medical_info - JSON format
education_num - záporné hodnoty
TBG_measured - false for all
TBG - ? celý stlpce - useless?
TSH - Vysoký rozdiel hodnôt
workclass - nesprávny formát ??, _?, ?
class - zlý formát |. _|....
fnlwght - ???? 
marital_status ?? Rôzne married - spouse + space
native country - space pred country
relationships - space pred relationships
FTI - vysoká varianca

